Sokoban 2021;
Options;0;
StaticCells;19;11
    #####          
    #   #          
    #   #          
  ###   ##         
  #      #         
### # ## #   ######
#   # ## #####  **#
#               **#
##### ### # ##  **#
    #     #########
    #######        
UniqueCells;0
DynamicCells;6
%;5;2
%;5;4
%;7;3
%;7;4
%;5;7
%;2;7
@;11;8;0;300;1;0
Keys;0
